###B    #
## #### #
## #    #
##   ## #
## #### #
#  ######
#A ######