A# B    #
 ##### ##
 # ### ##
 # #    #
 # #    #
     ## #
## #### #
#  ##   #
#      ##