###B#
##  #
## ##
## ##
#  ##
A ###